Aaliyah : Muffin aux pépites de chocolat, Lasagnes aux aubergines, Houmous, Café Gesha, Fraise, Hibiscus blanc
Alice : Huile d'amande, Colorant, Smoothie vert, Tarte au jacquier hachée, Huile d'olive
Anne : Carotte, Jus de fruits, Tempeh frit, Thé vert, Houmous, Kimchi, Tournesol
Antonio : Café, Serabi
Archie : Toutes les pierres précieuses, Pâtes au pesto de basilic, Burrito, Taco de poisson, Crème glacée, Citrouille
Ben : Banane, Thé vert, Champignons (tous types)
Betty : Chou-fleur, Jonquille, Thé vert, Gâteau Red Velvet
Bree : Taco de poisson, Jacquier, Taco végétalien
Chaem : Pâtes au pesto de basilic, Gnocchi, Pizza, Ramen aux fruits de mer, Ramen végétarien
Charles : Myrtille, Burrito, Biscuits, Diamant, Falafel, Fraise
Connor : Bok choy, Gâteau renversé à l'ananas, Saké, Huile de truffe blanche
Dinda : Salade fraîche, Bouquet de fleurs, Melon, Perle
Dippa : Betterave, Pommes de terre rissolées, Pizza hawaïenne, Morille, Radis
Eleanor : Papillons (aile d'oiseau, luciole, machaon tubulaire, papillon de nuit, machaon épicé), Thé vert, Litchi
Emily : Huile d'amande, Plateau grillé assorti, Huile d'olive, Bette sautée
Emma : Coquillages (trouvés sur la plage ou dans l'océan), Café, Tissu en coton, Thé vert, Taco de poisson, Chocolat chaud, Gâteau renversé à l'ananas, Citrouille, Taco végétalien
Erika : Nectar de canne, Confiture, Iris, Galette aux champignons et poivrons, Curry rouge
Eva : Biscuits, Diamants, Orchidée, Pivoine, Gâteau Red Velvet
Frank : Avocat, Poivron, Jus de fruits, Piment fort, Crêpes, Œufs au plat
Jack : Artichaut, Tarte aux fruits, Kimchi, Laitue
Jim : Sashimi, Ramen aux fruits de mer, Shiitake, Sushi, Wasabi
Joko : Beignet de banane, Café, Edamame, Riz frit, Ananas, Bette sautée, Yaourt
Kenny : Thé vert, Pommes de terre rissolées, Litchi, Kombucha, Amandes grillées, Soja, Taco végétalien
Kira : Bouquet de fleurs, Orchidée, Barre d'osmium
Leah : Chocolat chaud, Perle
Lily : Bonsaï, Fromage, Kimchi, Omurice, Onigiri, Frittata printanière, Tournesol, Vin
Ling : Varech argenté, Frittata printanière
Luke : Croissant au beurre, Lasagnes aux aubergines, Ratatouille, Soupe de tomates, Ragoût, Vin
Macy : Quartz bleu, Tarte aux fruits, Guacamole, Quartz rose, Vin
Mark : Flan aux œufs, Chocolat chaud, Shiitake, Soupe de tomates
Millie : Plateau grillé assorti, Melon, Olive, Canne à sucre, Ramen aux fruits de mer, Ramen végétarien
Nina : Beignet de banane, Bouquet de fleurs, Jus de fruits, Yaourt
Noah : Chaudrée de palourdes, Durian, Gnocchi, Champignon rôti, Œuf au plat, Sushi
Oliver : Pâtes au pesto de basilic, Glace, Ramen aux fruits de mer, Saumon fumé
Pablo : Casserole de chou-fleur, Riz frit, Pizza, Tarte à la citrouille, Poutine aux patates douces
Paul : Châtaigne, Houmous, Fraise
Rafael : Jus de fruits, Onyx, Sashimi
Raj : Tarte aux pommes, Café, Grains de café, Donut, Thé vert, Café Gesha, Grains de café Gesha, Feuille de thé
Randy : Pomme, Café, Homard, Vin
Sam : Truffe noire, Myrtille, Cactus, Jus de fruits, Tarte aux fruits, Jacquier, Truffe blanche
Scott : Jonquille, Flan aux œufs, Falafel, Géode, Raie pastenague géante, Arowana rouge royal, Mayonnaise, Murène jaune
Suki : Jonquille, Diamant, Smoothie vert, Tarte au jacquier hachée, Perle
Sunny : Champignon rôti
Surya : Tempeh aux herbes, Lodeh, Melon, Poisson-globe, Polenta aux champignons sauvages
Theo : Pousse de bambou, Boisson à la noix de coco, Taco de poisson, Goutte de neige, Murène jaune
Valentina : Pâtes au pesto de basilic, Taco de poisson, Curry vert, Chocolat chaud, Tarte à la citrouille, Curry rouge, Carambole
Wakuu : Cenil, Muffin aux pépites de chocolat, Mangue, Saumon, Taco végétalien
Walter : Carotte, Amandes grillées, Saké, Patate douce
Wataru : Poisson-ange, Poisson fantôme noir, Poisson-chat, Mandarine, Poisson-globe, Poisson arc-en-ciel
Yuri : Muffin aux pépites de chocolat, Sandwich au poisson, Poisson-grenouille, Curry vert, Homard, Curry rouge, Choucroute épicée
Zarah : Azurite, Poisson grillé, Houmous, Ramboutan, Serpentine
Zoe : Biscuits, Jus de fruits, Glace
